"DATE","B117","SA351","P1","B1617","TOTAL","C_SUM","B117_C_SUM","SA351_C_SUM","P1_C_SUM","B1617_C_SUM","B117_7DA","SA351_7DA","P1_7DA","B1617_7DA"
2020-12-15,1,0,0,0,1,1,1,0,0,0,1,0,0,0
2020-12-16,0,0,0,0,0,1,1,0,0,0,0.5,0,0,0
2020-12-17,1,0,0,0,1,2,2,0,0,0,0.666666666666667,0,0,0
2020-12-18,0,0,0,0,0,2,2,0,0,0,0.5,0,0,0
2020-12-19,0,0,0,0,0,2,2,0,0,0,0.4,0,0,0
2020-12-20,0,0,0,0,0,2,2,0,0,0,0.333333333333333,0,0,0
2020-12-21,1,0,0,0,1,3,3,0,0,0,0.428571428571429,0,0,0
2020-12-22,1,0,0,0,1,4,4,0,0,0,0.428571428571429,0,0,0
2020-12-23,1,0,0,0,1,5,5,0,0,0,0.571428571428571,0,0,0
2020-12-24,1,0,0,0,1,6,6,0,0,0,0.571428571428571,0,0,0
2020-12-25,0,0,0,0,0,6,6,0,0,0,0.571428571428571,0,0,0
2020-12-26,1,0,0,0,1,7,7,0,0,0,0.714285714285714,0,0,0
2020-12-27,0,0,0,0,0,7,7,0,0,0,0.714285714285714,0,0,0
2020-12-28,0,0,0,0,0,7,7,0,0,0,0.571428571428571,0,0,0
2020-12-29,0,0,0,0,0,7,7,0,0,0,0.428571428571429,0,0,0
2020-12-30,0,0,0,0,0,7,7,0,0,0,0.285714285714286,0,0,0
2020-12-31,0,0,0,0,0,7,7,0,0,0,0.142857142857143,0,0,0
2021-01-01,4,0,0,0,4,11,11,0,0,0,0.714285714285714,0,0,0
2021-01-02,1,0,0,0,1,12,12,0,0,0,0.714285714285714,0,0,0
2021-01-03,1,1,0,0,2,14,13,1,0,0,0.857142857142857,0.142857142857143,0,0
2021-01-04,1,0,0,0,1,15,14,1,0,0,1,0.142857142857143,0,0
2021-01-05,1,0,0,0,1,16,15,1,0,0,1.14285714285714,0.142857142857143,0,0
2021-01-06,1,0,0,0,1,17,16,1,0,0,1.28571428571429,0.142857142857143,0,0
2021-01-07,2,1,0,0,3,20,18,2,0,0,1.57142857142857,0.285714285714286,0,0
2021-01-08,1,0,0,0,1,21,19,2,0,0,1.14285714285714,0.285714285714286,0,0
2021-01-09,3,0,0,0,3,24,22,2,0,0,1.42857142857143,0.285714285714286,0,0
2021-01-10,0,0,0,0,0,24,22,2,0,0,1.28571428571429,0.142857142857143,0,0
2021-01-11,0,0,0,0,0,24,22,2,0,0,1.14285714285714,0.142857142857143,0,0
2021-01-12,2,0,0,0,2,26,24,2,0,0,1.28571428571429,0.142857142857143,0,0
2021-01-13,1,0,0,0,1,27,25,2,0,0,1.28571428571429,0.142857142857143,0,0
2021-01-14,1,0,0,0,1,28,26,2,0,0,1.14285714285714,0,0,0
2021-01-15,4,1,0,0,5,33,30,3,0,0,1.57142857142857,0.142857142857143,0,0
2021-01-16,6,0,0,0,6,39,36,3,0,0,2,0.142857142857143,0,0
2021-01-17,1,1,0,0,2,41,37,4,0,0,2.14285714285714,0.285714285714286,0,0
2021-01-18,1,1,0,0,2,43,38,5,0,0,2.28571428571429,0.428571428571429,0,0
2021-01-19,0,0,0,0,0,43,38,5,0,0,2,0.428571428571429,0,0
2021-01-20,3,1,0,0,4,47,41,6,0,0,2.28571428571429,0.571428571428571,0,0
2021-01-21,2,0,0,0,2,49,43,6,0,0,2.42857142857143,0.571428571428571,0,0
2021-01-22,3,0,0,0,3,52,46,6,0,0,2.28571428571429,0.428571428571429,0,0
2021-01-23,2,0,0,0,2,54,48,6,0,0,1.71428571428571,0.428571428571429,0,0
2021-01-24,1,0,0,0,1,55,49,6,0,0,1.71428571428571,0.285714285714286,0,0
2021-01-25,9,1,0,0,10,65,58,7,0,0,2.85714285714286,0.285714285714286,0,0
2021-01-26,0,0,0,0,0,65,58,7,0,0,2.85714285714286,0.285714285714286,0,0
2021-01-27,4,0,0,0,4,69,62,7,0,0,3,0.142857142857143,0,0
2021-01-28,12,0,0,0,12,81,74,7,0,0,4.42857142857143,0.142857142857143,0,0
2021-01-29,4,0,0,0,4,85,78,7,0,0,4.57142857142857,0.142857142857143,0,0
2021-01-30,6,0,0,0,6,91,84,7,0,0,5.14285714285714,0.142857142857143,0,0
2021-01-31,5,0,0,0,5,96,89,7,0,0,5.71428571428571,0.142857142857143,0,0
2021-02-01,7,1,0,0,8,104,96,8,0,0,5.42857142857143,0.142857142857143,0,0
2021-02-02,11,0,0,0,11,115,107,8,0,0,7,0.142857142857143,0,0
2021-02-03,9,3,0,0,12,127,116,11,0,0,7.71428571428571,0.571428571428571,0,0
2021-02-04,15,0,0,0,15,142,131,11,0,0,8.14285714285714,0.571428571428571,0,0
2021-02-05,22,0,0,0,22,164,153,11,0,0,10.7142857142857,0.571428571428571,0,0
2021-02-06,7,0,0,0,7,171,160,11,0,0,10.8571428571429,0.571428571428571,0,0
2021-02-07,5,1,0,0,6,177,165,12,0,0,10.8571428571429,0.714285714285714,0,0
2021-02-08,2,0,0,0,2,179,167,12,0,0,10.1428571428571,0.571428571428571,0,0
2021-02-09,13,0,0,0,13,192,180,12,0,0,10.4285714285714,0.571428571428571,0,0
2021-02-10,16,0,0,0,16,208,196,12,0,0,11.4285714285714,0.142857142857143,0,0
2021-02-11,10,0,0,0,10,218,206,12,0,0,10.7142857142857,0.142857142857143,0,0
2021-02-12,25,0,0,0,25,243,231,12,0,0,11.1428571428571,0.142857142857143,0,0
2021-02-13,8,0,0,0,8,251,239,12,0,0,11.2857142857143,0.142857142857143,0,0
2021-02-14,4,0,0,0,4,255,243,12,0,0,11.1428571428571,0,0,0
2021-02-15,7,0,0,0,7,262,250,12,0,0,11.8571428571429,0,0,0
2021-02-16,10,0,0,0,10,272,260,12,0,0,11.4285714285714,0,0,0
2021-02-17,8,0,0,0,8,280,268,12,0,0,10.2857142857143,0,0,0
2021-02-18,7,0,0,0,7,287,275,12,0,0,9.85714285714286,0,0,0
2021-02-19,15,0,0,0,15,302,290,12,0,0,8.42857142857143,0,0,0
2021-02-20,19,0,0,0,19,321,309,12,0,0,10,0,0,0
2021-02-21,11,0,0,0,11,332,320,12,0,0,11,0,0,0
2021-02-22,19,0,0,0,19,351,339,12,0,0,12.7142857142857,0,0,0
2021-02-23,24,0,0,0,24,375,363,12,0,0,14.7142857142857,0,0,0
2021-02-24,21,0,0,0,21,396,384,12,0,0,16.5714285714286,0,0,0
2021-02-25,32,0,0,0,32,428,416,12,0,0,20.1428571428571,0,0,0
2021-02-26,31,1,0,0,32,460,447,13,0,0,22.4285714285714,0.142857142857143,0,0
2021-02-27,16,0,0,0,16,476,463,13,0,0,22,0.142857142857143,0,0
2021-02-28,34,1,0,0,35,511,497,14,0,0,25.2857142857143,0.285714285714286,0,0
2021-03-01,14,0,0,0,14,525,511,14,0,0,24.5714285714286,0.285714285714286,0,0
2021-03-02,32,2,0,0,34,559,543,16,0,0,25.7142857142857,0.571428571428571,0,0
2021-03-03,26,1,0,0,27,586,569,17,0,0,26.4285714285714,0.714285714285714,0,0
2021-03-04,37,1,0,0,38,624,606,18,0,0,27.1428571428571,0.857142857142857,0,0
2021-03-05,29,2,0,0,31,655,635,20,0,0,26.8571428571429,1,0,0
2021-03-06,47,0,0,0,47,702,682,20,0,0,31.2857142857143,1,0,0
2021-03-07,32,1,0,0,33,735,714,21,0,0,31,1,0,0
2021-03-08,34,0,2,0,36,771,748,21,2,0,33.8571428571429,1,0.285714285714286,0
2021-03-09,47,0,0,0,47,818,795,21,2,0,36,0.714285714285714,0.285714285714286,0
2021-03-10,73,0,0,0,73,891,868,21,2,0,42.7142857142857,0.571428571428571,0.285714285714286,0
2021-03-11,58,0,0,0,58,949,926,21,2,0,45.7142857142857,0.428571428571429,0.285714285714286,0
2021-03-12,67,0,0,0,67,1016,993,21,2,0,51.1428571428571,0.142857142857143,0.285714285714286,0
2021-03-13,64,0,0,0,64,1080,1057,21,2,0,53.5714285714286,0.142857142857143,0.285714285714286,0
2021-03-14,74,1,1,0,76,1156,1131,22,3,0,59.5714285714286,0.142857142857143,0.428571428571429,0
2021-03-15,72,1,0,0,73,1229,1203,23,3,0,65,0.285714285714286,0.142857142857143,0
2021-03-16,111,0,2,0,113,1342,1314,23,5,0,74.1428571428571,0.285714285714286,0.428571428571429,0
2021-03-17,123,0,2,0,125,1467,1437,23,7,0,81.2857142857143,0.285714285714286,0.714285714285714,0
2021-03-18,192,4,2,0,198,1665,1629,27,9,0,100.428571428571,0.857142857142857,1,0
2021-03-19,126,0,1,0,127,1792,1755,27,10,0,108.857142857143,0.857142857142857,1.14285714285714,0
2021-03-20,153,0,2,0,155,1947,1908,27,12,0,121.571428571429,0.857142857142857,1.42857142857143,0
2021-03-21,174,1,5,0,180,2127,2082,28,17,0,135.857142857143,0.857142857142857,2,0
2021-03-22,167,0,6,0,173,2300,2249,28,23,0,149.428571428571,0.714285714285714,2.85714285714286,0
2021-03-23,187,0,10,0,197,2497,2436,28,33,0,160.285714285714,0.714285714285714,4,0
2021-03-24,239,0,4,1,244,2741,2675,28,37,1,176.857142857143,0.714285714285714,4.28571428571429,0.142857142857143
2021-03-25,206,0,7,0,213,2954,2881,28,44,1,178.857142857143,0.142857142857143,5,0.142857142857143
2021-03-26,243,0,12,0,255,3209,3124,28,56,1,195.571428571429,0.142857142857143,6.57142857142857,0.142857142857143
2021-03-27,271,0,8,0,279,3488,3395,28,64,1,212.428571428571,0.142857142857143,7.42857142857143,0.142857142857143
2021-03-28,241,0,8,0,249,3737,3636,28,72,1,222,0,7.85714285714286,0.142857142857143
2021-03-29,292,0,5,0,297,4034,3928,28,77,1,239.857142857143,0,7.71428571428571,0.142857142857143
2021-03-30,426,1,16,0,443,4477,4354,29,93,1,274,0.142857142857143,8.57142857142857,0.142857142857143
2021-03-31,421,0,21,0,442,4919,4775,29,114,1,300,0.142857142857143,11,0
2021-04-01,572,1,25,1,599,5518,5347,30,139,2,352.285714285714,0.285714285714286,13.5714285714286,0.142857142857143
2021-04-02,580,0,22,0,602,6120,5927,30,161,2,400.428571428571,0.285714285714286,15,0.142857142857143
2021-04-03,522,1,24,0,547,6667,6449,31,185,2,436.285714285714,0.428571428571429,17.2857142857143,0.142857142857143
2021-04-04,477,1,24,0,502,7169,6926,32,209,2,470,0.571428571428571,19.5714285714286,0.142857142857143
2021-04-05,507,0,31,0,538,7707,7433,32,240,2,500.714285714286,0.571428571428571,23.2857142857143,0.142857142857143
2021-04-06,787,1,38,0,826,8533,8220,33,278,2,552.285714285714,0.571428571428571,26.4285714285714,0.142857142857143
2021-04-07,798,1,33,0,832,9365,9018,34,311,2,606.142857142857,0.714285714285714,28.1428571428571,0.142857142857143
2021-04-08,878,3,47,1,929,10294,9896,37,358,3,649.857142857143,1,31.2857142857143,0.142857142857143
2021-04-09,745,3,38,1,787,11081,10641,40,396,4,673.428571428571,1.42857142857143,33.5714285714286,0.285714285714286
2021-04-10,732,2,44,1,779,11860,11373,42,440,5,703.428571428571,1.57142857142857,36.4285714285714,0.428571428571429
2021-04-11,660,4,35,1,700,12560,12033,46,475,6,729.571428571429,2,38,0.571428571428571
2021-04-12,656,4,33,0,693,13253,12689,50,508,6,750.857142857143,2.57142857142857,38.2857142857143,0.571428571428571
2021-04-13,861,3,53,0,917,14170,13550,53,561,6,761.428571428571,2.85714285714286,40.4285714285714,0.571428571428571
2021-04-14,975,7,79,1,1062,15232,14525,60,640,7,786.714285714286,3.71428571428571,47,0.714285714285714
2021-04-15,1029,1,72,2,1104,16336,15554,61,712,9,808.285714285714,3.42857142857143,50.5714285714286,0.857142857142857
2021-04-16,968,1,54,2,1025,17361,16522,62,766,11,840.142857142857,3.14285714285714,52.8571428571429,1
2021-04-17,916,7,63,1,987,18348,17438,69,829,12,866.428571428571,3.85714285714286,55.5714285714286,1
2021-04-18,844,2,77,0,923,19271,18282,71,906,12,892.714285714286,3.57142857142857,61.5714285714286,0.857142857142857
2021-04-19,856,8,79,1,944,20215,19138,79,985,13,921.285714285714,4.14285714285714,68.1428571428571,1
2021-04-20,1134,7,103,1,1245,21460,20272,86,1088,14,960.285714285714,4.71428571428571,75.2857142857143,1.14285714285714
2021-04-21,1200,5,89,1,1295,22755,21472,91,1177,15,992.428571428571,4.42857142857143,76.7142857142857,1.14285714285714
2021-04-22,1178,0,83,0,1261,24016,22650,91,1260,15,1013.71428571429,4.28571428571429,78.2857142857143,0.857142857142857
2021-04-23,1035,1,76,1,1113,25129,23685,92,1336,16,1023.28571428571,4.28571428571429,81.4285714285714,0.714285714285714
2021-04-24,1004,2,65,0,1071,26200,24689,94,1401,16,1035.85714285714,3.57142857142857,81.7142857142857,0.571428571428571
2021-04-25,1028,4,72,1,1105,27305,25717,98,1473,17,1062.14285714286,3.85714285714286,81,0.714285714285714
2021-04-26,1024,3,76,1,1104,28409,26741,101,1549,18,1086.14285714286,3.14285714285714,80.5714285714286,0.714285714285714
2021-04-27,1244,4,94,1,1343,29752,27985,105,1643,19,1101.85714285714,2.71428571428571,79.2857142857143,0.714285714285714
2021-04-28,1386,3,93,2,1484,31236,29371,108,1736,21,1128.42857142857,2.42857142857143,79.8571428571429,0.857142857142857
2021-04-29,1333,4,79,6,1422,32658,30704,112,1815,27,1150.57142857143,3,79.2857142857143,1.71428571428571
2021-04-30,1676,5,116,5,1802,34460,32380,117,1931,32,1242.14285714286,3.57142857142857,85,2.28571428571429
2021-05-01,787,5,30,7,829,35289,33167,122,1961,39,1211.14285714286,4,80,3.28571428571429
2021-05-02,902,3,39,4,948,36237,34069,125,2000,43,1193.14285714286,3.85714285714286,75.2857142857143,3.71428571428571
2021-05-03,566,7,26,2,601,36838,34635,132,2026,45,1127.71428571429,4.42857142857143,68.1428571428571,3.85714285714286
2021-05-04,466,0,41,0,507,37345,35101,132,2067,45,1016.57142857143,3.85714285714286,60.5714285714286,3.71428571428571
2021-05-05,443,2,28,2,475,37820,35544,134,2095,47,881.857142857143,3.71428571428571,51.2857142857143,3.71428571428571
2021-05-06,402,0,33,0,435,38255,35946,134,2128,47,748.857142857143,3.14285714285714,44.7142857142857,2.85714285714286
2021-05-07,396,2,33,5,436,38691,36342,136,2161,52,566,2.71428571428571,32.8571428571429,2.85714285714286
2021-05-08,340,1,24,3,368,39059,36682,137,2185,55,502.142857142857,2.14285714285714,32,2.28571428571429
2021-05-09,297,0,29,2,328,39387,36979,137,2214,57,415.714285714286,1.71428571428571,30.5714285714286,2
2021-05-10,353,0,12,6,371,39758,37332,137,2226,63,385.285714285714,0.714285714285714,28.5714285714286,2.57142857142857
2021-05-11,334,1,33,5,373,40131,37666,138,2259,68,366.428571428571,0.857142857142857,27.4285714285714,3.28571428571429
2021-05-12,381,3,26,2,412,40543,38047,141,2285,70,357.571428571429,1,27.1428571428571,3.28571428571429
2021-05-13,368,0,23,4,395,40938,38415,141,2308,74,352.714285714286,1,25.7142857142857,3.85714285714286
2021-05-14,288,0,21,3,312,41250,38703,141,2329,77,337.285714285714,0.714285714285714,24,3.57142857142857
2021-05-15,333,2,13,3,351,41601,39036,143,2342,80,336.285714285714,0.857142857142857,22.4285714285714,3.57142857142857
2021-05-16,223,1,13,5,242,41843,39259,144,2355,85,325.714285714286,1,20.1428571428571,4
2021-05-17,332,3,23,6,364,42207,39591,147,2378,91,322.714285714286,1.42857142857143,21.7142857142857,4
2021-05-18,257,1,12,5,275,42482,39848,148,2390,96,311.714285714286,1.42857142857143,18.7142857142857,4
2021-05-19,257,0,12,8,277,42759,40105,148,2402,104,294,1,16.7142857142857,4.85714285714286
2021-05-20,272,0,14,3,289,43048,40377,148,2416,107,280.285714285714,1,15.4285714285714,4.71428571428571
2021-05-21,251,0,14,4,269,43317,40628,148,2430,111,275,1,14.4285714285714,4.85714285714286
2021-05-22,180,1,13,6,200,43517,40808,149,2443,117,253.142857142857,0.857142857142857,14.4285714285714,5.28571428571429
2021-05-23,164,0,16,2,182,43699,40972,149,2459,119,244.714285714286,0.714285714285714,14.8571428571429,4.85714285714286
2021-05-24,194,0,8,4,206,43905,41166,149,2467,123,225,0.285714285714286,12.7142857142857,4.57142857142857
2021-05-25,184,0,12,12,208,44113,41350,149,2479,135,214.571428571429,0.142857142857143,12.7142857142857,5.57142857142857
2021-05-26,395,0,19,23,437,44550,41745,149,2498,158,234.285714285714,0.142857142857143,13.7142857142857,7.71428571428571
2021-05-27,390,0,25,4,419,44969,42135,149,2523,162,251.142857142857,0.142857142857143,15.2857142857143,7.85714285714286
2021-05-28,258,0,23,14,295,45264,42393,149,2546,176,252.142857142857,0.142857142857143,16.5714285714286,9.28571428571429
2021-05-29,288,0,16,10,314,45578,42681,149,2562,186,267.571428571429,0,17,9.85714285714286
2021-05-30,181,0,13,10,204,45782,42862,149,2575,196,270,0,16.5714285714286,11
2021-05-31,148,0,9,8,165,45947,43010,149,2584,204,263.428571428571,0,16.7142857142857,11.5714285714286
2021-06-01,304,0,23,19,346,46293,43314,149,2607,223,280.571428571429,0,18.2857142857143,12.5714285714286
2021-06-02,221,0,15,12,248,46541,43535,149,2622,235,255.714285714286,0,17.7142857142857,11
2021-06-03,155,1,15,12,183,46724,43690,150,2637,247,222.142857142857,0.142857142857143,16.2857142857143,12.1428571428571
2021-06-04,214,0,10,22,246,46970,43904,150,2647,269,215.857142857143,0.142857142857143,14.4285714285714,13.2857142857143
2021-06-05,155,0,12,20,187,47157,44059,150,2659,289,196.857142857143,0.142857142857143,13.8571428571429,14.7142857142857
2021-06-06,107,0,11,6,124,47281,44166,150,2670,295,186.285714285714,0.142857142857143,13.5714285714286,14.1428571428571
2021-06-07,84,0,7,15,106,47387,44250,150,2677,310,177.142857142857,0.142857142857143,13.2857142857143,15.1428571428571
2021-06-08,221,3,13,26,263,47650,44471,153,2690,336,165.285714285714,0.571428571428571,11.8571428571429,16.1428571428571
2021-06-09,103,0,5,15,123,47773,44574,153,2695,351,148.428571428571,0.571428571428571,10.4285714285714,16.5714285714286
2021-06-10,106,2,7,15,130,47903,44680,155,2702,366,141.428571428571,0.714285714285714,9.28571428571429,17
2021-06-11,103,1,13,25,142,48045,44783,156,2715,391,125.571428571429,0.857142857142857,9.71428571428571,17.4285714285714
2021-06-12,98,0,8,19,125,48170,44881,156,2723,410,117.428571428571,0.857142857142857,9.14285714285714,17.2857142857143
2021-06-13,64,0,8,11,83,48253,44945,156,2731,421,111.285714285714,0.857142857142857,8.71428571428571,18
2021-06-14,66,0,6,21,93,48346,45011,156,2737,442,108.714285714286,0.857142857142857,8.57142857142857,18.8571428571429
2021-06-15,62,0,7,43,112,48458,45073,156,2744,485,86,0.428571428571429,7.71428571428571,21.2857142857143
2021-06-16,72,2,5,30,109,48567,45145,158,2749,515,81.5714285714286,0.714285714285714,7.71428571428571,23.4285714285714
2021-06-17,58,0,5,29,92,48659,45203,158,2754,544,74.7142857142857,0.428571428571429,7.42857142857143,25.4285714285714
2021-06-18,46,0,8,29,83,48742,45249,158,2762,573,66.5714285714286,0.285714285714286,6.71428571428571,26
2021-06-19,28,0,4,27,59,48801,45277,158,2766,600,56.5714285714286,0.285714285714286,6.14285714285714,27.1428571428571
2021-06-20,27,0,1,12,40,48841,45304,158,2767,612,51.2857142857143,0.285714285714286,5.14285714285714,27.2857142857143
2021-06-21,34,0,4,15,53,48894,45338,158,2771,627,46.7142857142857,0.285714285714286,4.85714285714286,26.4285714285714
2021-06-22,47,0,4,21,72,48966,45385,158,2775,648,44.5714285714286,0.285714285714286,4.42857142857143,23.2857142857143
2021-06-23,28,1,2,14,45,49011,45413,159,2777,662,38.2857142857143,0.142857142857143,4,21
2021-06-24,46,0,1,19,66,49077,45459,159,2778,681,36.5714285714286,0.142857142857143,3.42857142857143,19.5714285714286
2021-06-25,27,0,3,27,57,49134,45486,159,2781,708,33.8571428571429,0.142857142857143,2.71428571428571,19.2857142857143
2021-06-26,15,0,2,20,37,49171,45501,159,2783,728,32,0.142857142857143,2.42857142857143,18.2857142857143
2021-06-27,14,0,0,14,28,49199,45515,159,2783,742,30.1428571428571,0.142857142857143,2.28571428571429,18.5714285714286
2021-06-28,22,1,0,9,32,49231,45537,160,2783,751,28.4285714285714,0.285714285714286,1.71428571428571,17.7142857142857
2021-06-29,17,0,2,34,53,49284,45554,160,2785,785,24.1428571428571,0.285714285714286,1.42857142857143,19.5714285714286
2021-06-30,14,1,1,26,42,49326,45568,161,2786,811,22.1428571428571,0.285714285714286,1.28571428571429,21.2857142857143
2021-07-01,16,0,1,12,29,49355,45584,161,2787,823,17.8571428571429,0.285714285714286,1.28571428571429,20.2857142857143
2021-07-02,11,4,0,12,27,49382,45595,165,2787,835,15.5714285714286,0.857142857142857,0.857142857142857,18.1428571428571
2021-07-03,18,6,2,9,35,49417,45613,171,2789,844,16,1.71428571428571,0.857142857142857,16.5714285714286
2021-07-04,9,2,2,8,21,49438,45622,173,2791,852,15.2857142857143,2,1.14285714285714,15.7142857142857
2021-07-05,12,0,2,11,25,49463,45634,173,2793,863,13.8571428571429,1.85714285714286,1.42857142857143,16
2021-07-06,14,0,4,21,39,49502,45648,173,2797,884,13.4285714285714,1.85714285714286,1.71428571428571,14.1428571428571
2021-07-07,21,0,0,14,35,49537,45669,173,2797,898,14.4285714285714,1.71428571428571,1.57142857142857,12.4285714285714
2021-07-08,17,0,1,13,31,49568,45686,173,2798,911,14.5714285714286,1.71428571428571,1.57142857142857,12.5714285714286
2021-07-09,9,1,0,12,22,49590,45695,174,2798,923,14.2857142857143,1.28571428571429,1.57142857142857,12.5714285714286
2021-07-10,6,0,1,10,17,49607,45701,174,2799,933,12.5714285714286,0.428571428571429,1.42857142857143,12.7142857142857
2021-07-11,8,0,0,9,17,49624,45709,174,2799,942,12.4285714285714,0.142857142857143,1.14285714285714,12.8571428571429
2021-07-12,5,0,0,9,14,49638,45714,174,2799,951,11.4285714285714,0.142857142857143,0.857142857142857,12.5714285714286
2021-07-13,6,0,2,16,24,49662,45720,174,2801,967,10.2857142857143,0.142857142857143,0.571428571428571,11.8571428571429
2021-07-14,5,3,2,23,33,49695,45725,177,2803,990,8,0.571428571428571,0.857142857142857,13.1428571428571
2021-07-15,5,0,0,26,31,49726,45730,177,2803,1016,6.28571428571429,0.571428571428571,0.714285714285714,15
2021-07-16,5,0,1,26,32,49758,45735,177,2804,1042,5.71428571428571,0.428571428571429,0.857142857142857,17
2021-07-17,3,0,0,26,29,49787,45738,177,2804,1068,5.28571428571429,0.428571428571429,0.714285714285714,19.2857142857143
2021-07-18,5,0,1,32,38,49825,45743,177,2805,1100,4.85714285714286,0.428571428571429,0.857142857142857,22.5714285714286
2021-07-19,0,2,1,39,42,49867,45743,179,2806,1139,4.14285714285714,0.714285714285714,1,26.8571428571429
2021-07-20,5,0,1,61,67,49934,45748,179,2807,1200,4,0.714285714285714,0.857142857142857,33.2857142857143
2021-07-21,4,0,5,67,76,50010,45752,179,2812,1267,3.85714285714286,0.285714285714286,1.28571428571429,39.5714285714286
2021-07-22,10,0,2,136,148,50158,45762,179,2814,1403,4.57142857142857,0.285714285714286,1.57142857142857,55.2857142857143
2021-07-23,5,0,4,107,116,50274,45767,179,2818,1510,4.57142857142857,0.285714285714286,2,66.8571428571429
2021-07-24,0,0,8,114,122,50396,45767,179,2826,1624,4.14285714285714,0.285714285714286,3.14285714285714,79.4285714285714
2021-07-25,3,0,2,74,79,50475,45770,179,2828,1698,3.85714285714286,0.285714285714286,3.28571428571429,85.4285714285714
2021-07-26,6,0,3,102,111,50586,45776,179,2831,1800,4.71428571428571,0,3.57142857142857,94.4285714285714
2021-07-27,8,0,8,164,180,50766,45784,179,2839,1964,5.14285714285714,0,4.57142857142857,109.142857142857
2021-07-28,3,0,9,178,190,50956,45787,179,2848,2142,5,0,5.14285714285714,125
2021-07-29,4,1,3,154,162,51118,45791,180,2851,2296,4.14285714285714,0.142857142857143,5.28571428571429,127.571428571429
2021-07-30,4,0,5,205,214,51332,45795,180,2856,2501,4,0.142857142857143,5.42857142857143,141.571428571429
2021-07-31,2,0,2,194,198,51530,45797,180,2858,2695,4.28571428571429,0.142857142857143,4.57142857142857,153
2021-08-01,4,0,4,125,133,51663,45801,180,2862,2820,4.42857142857143,0.142857142857143,4.85714285714286,160.285714285714
2021-08-02,0,0,4,101,105,51768,45801,180,2866,2921,3.57142857142857,0.142857142857143,5,160.142857142857
2021-08-03,1,0,0,186,187,51955,45802,180,2866,3107,2.57142857142857,0.142857142857143,3.85714285714286,163.285714285714
2021-08-04,2,0,3,351,356,52311,45804,180,2869,3458,2.42857142857143,0.142857142857143,3,188
2021-08-05,1,0,1,325,327,52638,45805,180,2870,3783,2,0,2.71428571428571,212.428571428571
2021-08-06,5,0,6,334,345,52983,45810,180,2876,4117,2.14285714285714,0,2.85714285714286,230.857142857143
2021-08-07,0,0,4,331,335,53318,45810,180,2880,4448,1.85714285714286,0,3.14285714285714,250.428571428571
2021-08-08,0,0,2,208,210,53528,45810,180,2882,4656,1.28571428571429,0,2.85714285714286,262.285714285714
2021-08-09,1,0,2,248,251,53779,45811,180,2884,4904,1.42857142857143,0,2.57142857142857,283.285714285714
2021-08-10,3,0,6,447,456,54235,45814,180,2890,5351,1.71428571428571,0,3.42857142857143,320.571428571429
2021-08-11,2,0,2,475,479,54714,45816,180,2892,5826,1.71428571428571,0,3.28571428571429,338.285714285714
2021-08-12,4,0,6,505,515,55229,45820,180,2898,6331,2.14285714285714,0,4,364
2021-08-13,4,0,2,514,520,55749,45824,180,2900,6845,2,0,3.42857142857143,389.714285714286
2021-08-14,3,0,0,404,407,56156,45827,180,2900,7249,2.42857142857143,0,2.85714285714286,400.142857142857
2021-08-15,0,0,0,364,364,56520,45827,180,2900,7613,2.42857142857143,0,2.57142857142857,422.428571428571
2021-08-16,0,0,0,352,352,56872,45827,180,2900,7965,2.28571428571429,0,2.28571428571429,437.285714285714
2021-08-17,1,0,1,592,594,57466,45828,180,2901,8557,2,0,1.57142857142857,458
2021-08-18,1,0,2,739,742,58208,45829,180,2903,9296,1.85714285714286,0,1.57142857142857,495.714285714286
2021-08-19,3,0,1,674,678,58886,45832,180,2904,9970,1.71428571428571,0,0.857142857142857,519.857142857143
2021-08-20,0,0,4,731,735,59621,45832,180,2908,10701,1.14285714285714,0,1.14285714285714,550.857142857143
2021-08-21,0,0,2,607,609,60230,45832,180,2910,11308,0.714285714285714,0,1.42857142857143,579.857142857143
2021-08-22,1,0,0,432,433,60663,45833,180,2910,11740,0.857142857142857,0,1.42857142857143,589.571428571429
2021-08-23,0,0,2,568,570,61233,45833,180,2912,12308,0.857142857142857,0,1.71428571428571,620.428571428571
2021-08-24,0,0,3,976,979,62212,45833,180,2915,13284,0.714285714285714,0,2,675.285714285714
2021-08-25,2,0,1,947,950,63162,45835,180,2916,14231,0.857142857142857,0,1.85714285714286,705
2021-08-26,1,0,3,1045,1049,64211,45836,180,2919,15276,0.571428571428571,0,2.14285714285714,758
2021-08-27,2,0,0,1104,1106,65317,45838,180,2919,16380,0.857142857142857,0,1.57142857142857,811.285714285714
2021-08-28,1,0,0,849,850,66167,45839,180,2919,17229,1,0,1.28571428571429,845.857142857143
2021-08-29,3,0,0,784,787,66954,45842,180,2919,18013,1.28571428571429,0,1.28571428571429,896.142857142857
2021-08-30,0,0,3,837,840,67794,45842,180,2922,18850,1.28571428571429,0,1.42857142857143,934.571428571429
2021-08-31,1,0,0,1187,1188,68982,45843,180,2922,20037,1.42857142857143,0,1,964.714285714286
2021-09-01,1,0,0,1227,1228,70210,45844,180,2922,21264,1.28571428571429,0,0.857142857142857,1004.71428571429
2021-09-02,0,0,0,1268,1268,71478,45844,180,2922,22532,1.14285714285714,0,0.428571428571429,1036.57142857143
2021-09-03,0,0,0,1164,1164,72642,45844,180,2922,23696,0.857142857142857,0,0.428571428571429,1045.14285714286
2021-09-04,2,0,1,1323,1326,73968,45846,180,2923,25019,1,0,0.571428571428571,1112.85714285714
2021-09-05,1,0,0,738,739,74707,45847,180,2923,25757,0.714285714285714,0,0.571428571428571,1106.28571428571
2021-09-06,1,0,0,1186,1187,75894,45848,180,2923,26943,0.857142857142857,0,0.142857142857143,1156.14285714286
2021-09-07,1,0,0,1069,1070,76964,45849,180,2923,28012,0.857142857142857,0,0.142857142857143,1139.28571428571
2021-09-08,0,0,0,1337,1337,78301,45849,180,2923,29349,0.714285714285714,0,0.142857142857143,1155
2021-09-09,0,0,0,1256,1256,79557,45849,180,2923,30605,0.714285714285714,0,0.142857142857143,1153.28571428571
2021-09-10,0,0,0,872,872,80429,45849,180,2923,31477,0.714285714285714,0,0.142857142857143,1111.57142857143
2021-09-11,0,0,0,890,890,81319,45849,180,2923,32367,0.428571428571429,0,0,1049.71428571429
2021-09-12,1,0,0,575,576,81895,45850,180,2923,32942,0.428571428571429,0,0,1026.42857142857
2021-09-13,1,0,0,465,466,82361,45851,180,2923,33407,0.428571428571429,0,0,923.428571428571
2021-09-14,1,0,0,632,633,82994,45852,180,2923,34039,0.428571428571429,0,0,861
2021-09-15,3,0,0,669,672,83666,45855,180,2923,34708,0.857142857142857,0,0,765.571428571429
2021-09-16,2,0,0,704,706,84372,45857,180,2923,35412,1.14285714285714,0,0,686.714285714286
2021-09-17,1,0,0,689,690,85062,45858,180,2923,36101,1.28571428571429,0,0,660.571428571429
2021-09-18,0,0,1,680,681,85743,45858,180,2924,36781,1.28571428571429,0,0.142857142857143,630.571428571429
2021-09-19,0,0,0,585,585,86328,45858,180,2924,37366,1.14285714285714,0,0.142857142857143,632
2021-09-20,0,0,0,561,561,86889,45858,180,2924,37927,1,0,0.142857142857143,645.714285714286
2021-09-21,1,0,0,640,641,87530,45859,180,2924,38567,1,0,0.142857142857143,646.857142857143
2021-09-22,0,0,0,714,714,88244,45859,180,2924,39281,0.571428571428571,0,0.142857142857143,653.285714285714
2021-09-23,1,0,0,709,710,88954,45860,180,2924,39990,0.428571428571429,0,0.142857142857143,654
2021-09-24,0,0,0,733,733,89687,45860,180,2924,40723,0.285714285714286,0,0.142857142857143,660.285714285714
2021-09-25,0,0,0,551,551,90238,45860,180,2924,41274,0.285714285714286,0,0,641.857142857143
2021-09-26,0,0,0,646,646,90884,45860,180,2924,41920,0.285714285714286,0,0,650.571428571429
2021-09-27,0,0,0,534,534,91418,45860,180,2924,42454,0.285714285714286,0,0,646.714285714286
2021-09-28,0,0,0,580,580,91998,45860,180,2924,43034,0.142857142857143,0,0,638.142857142857
2021-09-29,1,0,0,755,756,92754,45861,180,2924,43789,0.285714285714286,0,0,644
2021-09-30,0,0,0,622,622,93376,45861,180,2924,44411,0.142857142857143,0,0,631.571428571429
2021-10-01,1,0,0,655,656,94032,45862,180,2924,45066,0.285714285714286,0,0,620.428571428571
2021-10-02,1,0,0,510,511,94543,45863,180,2924,45576,0.428571428571429,0,0,614.571428571429
2021-10-03,0,0,0,437,437,94980,45863,180,2924,46013,0.428571428571429,0,0,584.714285714286
2021-10-04,0,0,0,389,389,95369,45863,180,2924,46402,0.428571428571429,0,0,564
2021-10-05,0,0,0,590,590,95959,45863,180,2924,46992,0.428571428571429,0,0,565.428571428571
2021-10-06,1,0,0,623,624,96583,45864,180,2924,47615,0.428571428571429,0,0,546.571428571429
2021-10-07,0,0,0,598,598,97181,45864,180,2924,48213,0.428571428571429,0,0,543.142857142857
2021-10-08,0,0,0,506,506,97687,45864,180,2924,48719,0.285714285714286,0,0,521.857142857143
2021-10-09,0,0,0,447,447,98134,45864,180,2924,49166,0.142857142857143,0,0,512.857142857143
2021-10-10,0,0,0,329,329,98463,45864,180,2924,49495,0.142857142857143,0,0,497.428571428571
2021-10-11,1,0,0,258,259,98722,45865,180,2924,49753,0.285714285714286,0,0,478.714285714286
2021-10-12,0,0,0,283,283,99005,45865,180,2924,50036,0.285714285714286,0,0,434.857142857143
2021-10-13,1,0,0,435,436,99441,45866,180,2924,50471,0.285714285714286,0,0,408
2021-10-14,0,0,0,504,504,99945,45866,180,2924,50975,0.285714285714286,0,0,394.571428571429
2021-10-15,0,0,0,379,379,100324,45866,180,2924,51354,0.285714285714286,0,0,376.428571428571
2021-10-16,1,0,0,395,396,100720,45867,180,2924,51749,0.428571428571429,0,0,369
2021-10-17,0,0,0,262,262,100982,45867,180,2924,52011,0.428571428571429,0,0,359.428571428571
2021-10-18,0,0,0,298,298,101280,45867,180,2924,52309,0.285714285714286,0,0,365.142857142857
2021-10-19,1,0,0,427,428,101708,45868,180,2924,52736,0.428571428571429,0,0,385.714285714286
2021-10-20,0,0,0,360,360,102068,45868,180,2924,53096,0.285714285714286,0,0,375
2021-10-21,0,0,0,319,319,102387,45868,180,2924,53415,0.285714285714286,0,0,348.571428571429
2021-10-22,0,0,0,323,323,102710,45868,180,2924,53738,0.285714285714286,0,0,340.571428571429
2021-10-23,0,0,0,260,260,102970,45868,180,2924,53998,0.142857142857143,0,0,321.285714285714
2021-10-24,0,0,0,178,178,103148,45868,180,2924,54176,0.142857142857143,0,0,309.285714285714
2021-10-25,0,0,0,240,240,103388,45868,180,2924,54416,0.142857142857143,0,0,301
2021-10-26,0,0,0,316,316,103704,45868,180,2924,54732,0,0,0,285.142857142857
2021-10-27,0,0,0,269,269,103973,45868,180,2924,55001,0,0,0,272.142857142857
2021-10-28,0,0,0,276,276,104249,45868,180,2924,55277,0,0,0,266
2021-10-29,0,0,0,283,283,104532,45868,180,2924,55560,0,0,0,260.285714285714
2021-10-30,0,0,0,164,164,104696,45868,180,2924,55724,0,0,0,246.571428571429
2021-10-31,0,0,0,153,153,104849,45868,180,2924,55877,0,0,0,243
2021-11-01,0,0,0,161,161,105010,45868,180,2924,56038,0,0,0,231.714285714286
2021-11-02,0,0,0,260,260,105270,45868,180,2924,56298,0,0,0,223.714285714286
2021-11-03,1,0,0,268,269,105539,45869,180,2924,56566,0.142857142857143,0,0,223.571428571429
2021-11-04,0,0,0,218,218,105757,45869,180,2924,56784,0.142857142857143,0,0,215.285714285714
2021-11-05,0,0,0,270,270,106027,45869,180,2924,57054,0.142857142857143,0,0,213.428571428571
2021-11-06,0,0,0,211,211,106238,45869,180,2924,57265,0.142857142857143,0,0,220.142857142857
2021-11-07,0,0,0,138,138,106376,45869,180,2924,57403,0.142857142857143,0,0,218
2021-11-08,0,0,0,188,188,106564,45869,180,2924,57591,0.142857142857143,0,0,221.857142857143
2021-11-09,0,0,0,207,207,106771,45869,180,2924,57798,0.142857142857143,0,0,214.285714285714
2021-11-10,0,0,0,223,223,106994,45869,180,2924,58021,0,0,0,207.857142857143
2021-11-11,0,0,0,165,165,107159,45869,180,2924,58186,0,0,0,200.285714285714
2021-11-12,0,0,0,186,186,107345,45869,180,2924,58372,0,0,0,188.285714285714
2021-11-13,0,0,0,131,131,107476,45869,180,2924,58503,0,0,0,176.857142857143
2021-11-14,0,0,0,139,139,107615,45869,180,2924,58642,0,0,0,177
2021-11-15,1,0,0,161,162,107777,45870,180,2924,58803,0.142857142857143,0,0,173.142857142857
2021-11-16,0,0,0,175,175,107952,45870,180,2924,58978,0.142857142857143,0,0,168.571428571429
2021-11-17,0,0,0,176,176,108128,45870,180,2924,59154,0.142857142857143,0,0,161.857142857143
2021-11-18,0,0,0,179,179,108307,45870,180,2924,59333,0.142857142857143,0,0,163.857142857143
2021-11-19,0,0,0,194,194,108501,45870,180,2924,59527,0.142857142857143,0,0,165
2021-11-20,0,0,0,150,150,108651,45870,180,2924,59677,0.142857142857143,0,0,167.714285714286
2021-11-21,0,0,0,100,100,108751,45870,180,2924,59777,0.142857142857143,0,0,162.142857142857
2021-11-22,0,0,0,114,114,108865,45870,180,2924,59891,0,0,0,155.428571428571
2021-11-23,0,0,0,149,149,109014,45870,180,2924,60040,0,0,0,151.714285714286
2021-11-24,0,0,0,24,24,109038,45870,180,2924,60064,0,0,0,130
